**********
*P       *
*        *
***      *
*    M   *
*        *
*        *
*  M   ***
*       G*
**********